1 0
7 7
XXXXXXX
  X   X
X X X X
X X X X
X XXX X
X     X
XXXXXEX
0 5 6 5 MEPhI